2 13 31
###############################
#p * *2       *  ** * *      *#
# # # # #*# # #*# # # # # #*# #
#    * * x** **      *    **  #
# #*# # # # # # #*# # # # # #*#
#          *     **      *  **#
# # #b# # # # # #*#*#*#*# # # #
#   *        *   * * * *      #
# # # # #*# # # # # # #*# #*# #
#   ****         *            #
# # # # # # # # # #*# # # # #*#
#  ** *   *    2              #
###############################